Coming Home
An Interactive Fiction by Geraldo
Release 1 / Serial number 210130 / Inform 7 build 6M62 (I6/v6.33 lib 6/12N) SD

Amestris, January 17º of 2101, a new inextinguishable source of clean energy was discovered. The Amestris government presented the world it's new discovery: ``This can start a new era for the human race!`` they said excitedly.

By this time Shambala, a neighbor country known for it's violent diplomacy and ruled by a dictator, organized an invasion to Amestris to claim the new energy source by force.

During the attack the Amestris Guard fought bravely to repel Shambala's Incursion and it's soldiers, but you and your superior officer, Colonel Nelson, are captured by the Shambala army in an attempt to extract sensitive information.

At some point, in a moment of distraction of the enemy you manage to escape and follow them to their hideout. It's an isolated and abandoned house. You wait until night's arrival but you know Nelson's time is running out.

It is time to act!

Even though alone and unarmed, you are the best chance to rescue Colonel Nelson and your country!

Porch
It's dark now, you can't be seen out here. You can see an armed guard sleeping in the chair.

You can see Garden arc, Garage door, Main door, a Wooden chair (on which is Private1) and bucket (in which are Main key, candle and string) here.

>n
(first opening Main door)
It seems to be locked.

>n
Living Room

>s
Hall

* * *

>n
(first opening Main door)
It seems to be locked.

>up
Upper Hall
You can see Stairs here.

* * *

>n
(first opening Main door)
It seems to be locked.

>unlock Main door
What do you want to unlock Main door with?

* * *

>n
(first opening Main door)
It seems to be locked.

I beg your pardon?

I beg your pardon?

* * *

>n
(first opening Main door)
It seems to be locked.

>get main key
A chill runs up your spine. You look at the private when he turns to you but he's still sleeping. Lucky me.

Taken.

>unlock main door
(with Main key)
You unlock Main door.

>n
(first opening Main door)

Hall
You see a dark room at north, stairs for the second floor and hear sounds like a radio from the Lavabo at east.

You can see Main door and Lavabo door here.

Ok, I'm in. Now, where's Nelson...

>look
Hall
You see a dark room at north, stairs for the second floor and hear sounds like a radio from the Lavabo at east.

You can see Main door and Lavabo door here.

>e
(first opening Lavabo door)

    *** Fuck! There's someone using the bathroom! You got shot and die. GAME OVER ***

Would you like to RESTART, RESTORE a saved game, QUIT or UNDO the last command?

>undo
Hall
[Previous turn undone.]

* * *

>look
Porch
You can see You here.

>up
You can't go that way.

>n
Hall
You can see Stairs here.

>look
Hall
You can see Stairs here.

>n
Living Room

>s
Hall
You can see Stairs here.

>s
Porch
You can see You here.

>n
Hall
You can see Stairs here.

>e
Lavabo

>w
Hall
You can see Stairs here.

>up
Upper Hall
You can see Stairs here.

>down
Hall
You can see Stairs here.

>climb stairs
Upper Hall
You can see Stairs here.

>climb stairs
Hall
You can see Stairs here.

>stairs
That's not a verb I recognise.

>enter Living Room
You can't see any such thing.

>enter staris
You can't see any such thing.

>enter stairs
Upper Hall
You can see Stairs here.

* * *

>get key
A chill runs up your spine
Taken.

>unlock door
(with Main key)
You unlock Main door.

>n
(first opening Main door)

Hall
You can see Main door here.

>up
Upper Hall

>down
Hall
You can see Main door here.

* * *

>get key
A chill runs up your spine
Taken.

>unlock door with key
You unlock Main door.

>enter
You get onto Wooden chair.

>out
You get off Wooden chair.

Porch
You can see Main door, Wooden chair, Old box (in which are candle and string) and bucket (empty) here.

>n
(first opening Main door)

Hall
You can see Main door here.

>close door
You close Main door.

>scenes
Scene 'Entire Game' playing (for 6 mins now)
Scene 'Being Outside the House' ended
(Scene monitoring now switched on. Type "scenes off" to switch it off again.)

* * *

>sit
What do you want to sit on?

>sit on wooden chair
You cant sit in it

* * *

>sit on chair
You feel confortable

>look chair
You see nothing special about Wooden chair.

>get wooden chair
That's fixed in place.

>enter chair
That's not something you can enter.

* * *

>sit on chair
You feel confortable

>look
Porch (on Wooden chair)
You can see Main door, Main key and You here.

* * *

>sit on chair
You feel confortable

>up
(first getting off Wooden chair)
You can't go that way.

* * *

>sit on chair
You feel confortable

>out
You get off Wooden chair.

Porch
You can see Main door, Main key, You, Wooden chair, Old box (empty), thing1, thing2 and thing3 here.

>get thing1
Taken.

>put thing1 on chair
You put thing1 on Wooden chair.

>sit on chair
You can't sit in the Wooden chair, it is occupied

* * *

>look
Porch
You can see Main door, Main key, You, Wooden chair (on which is thing1), Old box (empty), thing2 and thing3 here.

I beg your pardon?

>out
But you aren't in anything at the moment.

>look
Porch
You can see Main door, Main key, You, Wooden chair (on which is thing1), Old box (empty), thing2 and thing3 here.

* * *

>enter chair
You get onto Wooden chair.

>out
You get off Wooden chair.

Porch
You can see Main door, Main key, You and Wooden chair here.

>sit on chair
You cant sit in it

>is chair seatable?
That's not a verb I recognise.

>help
That's not a verb I recognise.

* * *

>test me
>--> No test scripts exist for this game.

* * *

>sit on box
You can't sit on Old box

>look
Porch
You can see Main door, Main key, You, Wooden chair and Old box (empty) here.

>enter bpx
You can't see any such thing.

>enter box
That's not something you can enter.

* * *

>sit on box
You can't sit on Old box

>sit on chair
You can't sit on Wooden chair
You feel confortable

* * *

>sit on box
You can't sit on Old box

>get box
Taken.

>put box on chair
You put Old box on Wooden chair.

>sit chair
I didn't understand that sentence.

>sit on chair
You can't sit in a occupied chair

>get box
Taken.

>sit on chair
You feel confortable

* * *

>look
Porch (on Wooden chair)
You can see Main door, Main key and You here.

>get key
A chill runs up your spine
Taken.

* * *

>sit on box
You can't sit on Old box

>enter box
That's not something you can enter.

>enter chair
You get onto Wooden chair.

>look
Porch (on Wooden chair)
You can see Main door, Main key, You, Old box (empty), thing1, thing2 and thing3 here.

>get all
Main key: A chill runs up your spine
Taken.
You: Taken.
Old box: Taken.
thing1: Taken.
thing2: Taken.
thing3: Taken.

>i
You are carrying:
  thing3
  thing2
  thing1
  Old box
  You
  Main key

>drop me
You lack the dexterity.

>drop all
thing3: There is no more room on Wooden chair.
thing2: There is no more room on Wooden chair.
thing1: There is no more room on Wooden chair.
Old box: There is no more room on Wooden chair.
You: There is no more room on Wooden chair.
Main key: There is no more room on Wooden chair.

>exit
You get off Wooden chair.

Porch
You can see Main door and Wooden chair here.

>drop all
thing3: Dropped.
thing2: Dropped.
thing1: Dropped.
Old box: Dropped.
You: Dropped.
Main key: Dropped.

>get me
You are always self-possessed.

>i
You are carrying nothing.

>get all
Main key: A chill runs up your spine
Taken.
You: Taken.
Old box: Taken.
thing1: Taken.
thing2: Taken.
thing3: Taken.

* * *

>i
You are carrying:
  thing3
  thing2
  thing1
  Old box
  You
  Main key

>actions
Actions listing on.

>rules
Rules tracing now switched on. Type "rules off" to switch it off again, or "rules all" to include even rules which do not apply.

>actions off
Actions listing off.

>rules off
Rules tracing now switched off. Type "rules" to switch it on again.

>drop all
thing3: Dropped.
thing2: Dropped.
thing1: Dropped.
Old box: Dropped.
You: Dropped.
Main key: Dropped.

>get all
Main key: A chill runs up your spine
Taken.
You: Taken.
Old box: Taken.
thing1: Taken.
thing2: Taken.
thing3: Taken.

* * *

>get box
Taken.

* * *

>sit chair
I didn't understand that sentence.

>sit on chair
You cant sit in a occupied chair

* * *

>get Main key
A chill runs up your spine. You look at the private when he turns to you but he's still sleeping. Lucky me.

Taken.

>n
(first opening Main door)
It seems to be locked.

>open Main door
It seems to be locked.

>unlock Main door with Main key
You unlock Main door.

>n
(first opening Main door)

Hall
You can see Main door here.

>n
Living Room

* * *

>n
(first opening Main door)
It seems to be locked.

>unlock Main door
(with Main key)
You unlock Main door.

>n
(first opening Main door)

Hall
You can hear sounds like a radio from the Lavabo at east.

You can see Main door and Lavabo door here.

>close Main door
You close Main door.

* * *

>get Main key
A chill runs up your spine. You look at the private when he turns to you but he's still sleeping. Lucky me.

Taken.

>unlock Main door
(with Main key)
You unlock Main door.

>open Main door
You open Main door.

>n
Hall
You can hear sounds like a radio from the Lavabo at east.

You can see Main door and Lavabo door here.

>close Main door
You close Main door.

>look
Hall
You can hear sounds like a radio from the Lavabo at east.

You can see Main door and Lavabo door here.

* * *

>northeast
Garden
You go through a narrow path until reach an elevated window at west. It`s so hidden that almost feels like you found a secret path. You can hear Colonel's voice at the inside.

>look
Garden
You go through a narrow path until reach an elevated window. It`s so hidden that almost feels like you found a secret path. You can hear a familiar voice from inside.

>s
You can't go that way.

>southwest
Porch
It's dark, you can't be seen out here. You can see an armed guard sleeping in the chair.

You can see Main door, a Wooden chair (on which is Private1) and bucket (in which are Main key, candle and string) here.

* * *

>northeast
Garden
You go through a narrow path until reach an elevated window at west. It`s so hidden that almost feels like you found a secret path. You can hear Colonel's voice at the inside.

>southeast
You can't go that way.

>southwest
Porch
It's dark, you can't be seen out here. You can see an armed guard sleeping in the chair.

You can see Main door, a Wooden chair (on which is Private1) and bucket (in which are Main key, candle and string) here.

>Wodden chair
That's not a verb I recognise.

>examine Wodden chair
You can't see any such thing.

>examine Wooden chair
On the Wooden chair is Private1.

>examine
What do you want to examine?

>Private1
You see nothing special about Private1.

* * *

>northeast
Garden
You go through a narrow path until reach an elevated window at west. It`s so hidden that almost feels like you found a secret path. You can hear Colonel's voice at the inside.

>west
(first opening Elevated Window)
It seems to be locked.

* * *

>examine Private1
You see nothing special about Private1.

>Private1
That's not a verb I recognise.

>look Private1
You see nothing special about Private1.

>hit Private1
Violence isn't the answer to this one.

>ask Private1
What do you want to ask Private1 for?

>ask Private1 who are you
I didn't understand that sentence.

>examine Wooden chair
On the Wooden chair is Private1.

* * *

>silently get Main key
That's not a verb I recognise.

>get Main key silently
I only understood you as far as wanting to get Main key.

>get Main key
A chill runs up your spine
Taken.

* * *

>Garage door
That's not a verb I recognise.

>look Garage door
You see nothing special about Garage door.

>n
(first opening Main door)
It seems to be locked.

>w
You can't go that way.

>s
You can't go that way.

>look
Porch
It's dark, you can't be seen out here. You can see an armed guard sleeping in the chair.

You can see Garage door, Main door, a Wooden chair (on which is Private1) and bucket (in which are Main key, candle and string) here.

>examine Private1
You see nothing special about Private1.

* * *

>get Main Key
A chill runs up your spine. You look at the private when he turns to you but he's still sleeping. Lucky me.

Taken.

>unlock Main door
(with Main key)
You unlock Main door.

>n
(first opening Main door)

Hall
You see a dark room at north and hear sounds like a radio from the Lavabo at east.

You can see Main door and Lavabo door here.

>e
(first opening Lavabo door)

    *** Fuck! There's someone using the bathroom! You got shot and die. GAME OVER ***

Would you like to RESTART, RESTORE a saved game, QUIT or UNDO the last command?

* * *

>n
(first opening Main door)

Hall
You see a dark room at north and hear sounds like a radio from the Lavabo at east.

You can see Main door and Lavabo door here.

>s
Porch
It's dark, you can't be seen out here. You can see an armed guard sleeping in the chair.

You can see Main door, Garage door, a Wooden chair (on which is Private1) and bucket (in which are candle and string) here.

>n
Hall
You see a dark room at north and hear sounds like a radio from the Lavabo at east.

You can see Main door and Lavabo door here.

>e
(first opening Lavabo door)

    *** Fuck! There's someone using the bathroom! You got shot and die. GAME OVER ***

Would you like to RESTART, RESTORE a saved game, QUIT or UNDO the last command?

* * *

>get main key
A chill runs up your spine. You look at the private when he turns to you but he's still sleeping. Lucky me.

Taken.

* * *

>n
(first opening Main door)

Hall
You see a dark room at north, stairs for the second floor and hear sounds like a radio from the Lavabo at east.

You can see Main door and Lavabo door here.

Ok, I'm in. Now, where's Nelson...

>e
(first opening Lavabo door)

    *** Fuck! There's someone using the bathroom! You got shot and die. GAME OVER ***

Would you like to RESTART, RESTORE a saved game, QUIT or UNDO the last command?

>e
Please give one of the answers above.

Would you like to RESTART, RESTORE a saved game, QUIT or UNDO the last command?

* * *

>undo
Hall
[Previous turn undone.]

>open Lavabo door
*** Fuck! There's someone using the bathroom! You got shot and die. GAME OVER ***

Would you like to RESTART, RESTORE a saved game, QUIT or UNDO the last command?

* * *

>n
(first opening Main door)

Hall
You see a dark room at north, stairs for the second floor and hear sounds like a radio from the Lavabo at east.

You can see Main door and Lavabo door here.

Ok, I'm in. Now, where's Nelson...

>n
Living Room
The room is lit only by the muted TV light.

You can see Home office door, Living room door, Dining Room door, Couch and TV here.

You can hear voices at east, one of wich is Colonel's voice.

>n
(first opening Dining Room door)

Dining Room
The dimly lit room highlights the bright screen of something on the table.

You can see Dining Room door, Kitchen portal and Messy table (on which is Laptop) here.

>look
Dining Room
The dimly lit room highlights the bright screen of something on the table.

You can see Dining Room door, Kitchen portal and Messy table (on which is Laptop) here.

>examine messy table
There's some comns gear and ammo all around the table. There's a laptop too

On Messy table is Laptop.

>examine laptop
It's display shows a kind of report: ``...and unfortunately one of the prisioners have scaped. He's unarmed and we have armed guards patrolling outside. The other prisioner is a Colonel, so he's being interrogated by Sargeant at Home Office for some sensitive info. They are locked inside just in case the prisioner tries to flee, but it's Spare Key is with Liuetenant at second floor... `` Great, now I know where to go.

>examine messy table
There's some comns gear and ammo all around the table. There's a laptop too

On Messy table is Laptop.

* * *

>n
(first opening Dining Room door)

Dining Room
The dimly lit room highlights the bright screen of something on the table.

You can see Dining Room door, Kitchen portal and Messy table (on which is Laptop) here.

>examine messy table
There's some comns gear and ammo all around the table.

On Messy table is Laptop.

>examine laptop
It's display shows some kind of report:

``...and unfortunately one of the prisioners have scaped. He's unarmed and we have armed guards patrolling outside. The other prisioner is a Colonel, so he's being interrogated by Sargeant at Home Office for some sensitive info. They are locked inside just in case the prisioner tries to flee, but it's Spare Key is with Liuetenant... ``

Great, now I know what to search.

>s
Living Room
The room is lit only by the muted TV light.

You can see Dining Room door, Home office door, Living room door, Couch and TV here.

You can hear voices at east, one of wich is Colonel's voice.

>s
Hall
You see a dark room at north, stairs for the second floor and hear sounds like a radio from the Lavabo at east.

You can see Main door and Lavabo door here.

>e
(first opening Lavabo door)

    *** Fuck! There's someone using the bathroom! You got shot and die. GAME OVER ***

Would you like to RESTART, RESTORE a saved game, QUIT or UNDO the last command?

* * *

>undo
Hall
[Previous turn undone.]

>examine stairs
You see nothing special about Stairs.

>enter stairs
Upper Hall
You can see Small bedroom door, Medium bedroom door and Large bedroom door here.

>n
Large Bedroom
You can see Large bedroom door, Inner bathroom door and Bed (on which are Spare key and Liutenant's Cap) here.

* * *

>s
Hall
You see a dark room at north, stairs for the second floor and hear sounds like a radio from the Lavabo at east.

You can see Main door and Lavabo door here.

>enter stairs
Upper Hall
You can see Small bedroom door, Medium bedroom door and Large bedroom door here.

* * *

>n
Large Bedroom
You can see Large bedroom door, Inner bathroom door and Bed (on which are Spare key and Liutenant's Cap) here.

>get spare key
You hear a huge noise of someone slamming a door and shouting:

``I coudn't get any info from him yet Liutenant, he passed out! You try next! I'm gonna eat something and finish the report!``

And then someone shout back from the room right beside you:

``I'll finish here and I'll be there already. Just a sec!``

You freeze by the proximity of the voice and the only thing  you can think about is ``I need to move right now!``

Nelson I'm comming buddy!

>s
Upper Hall
You can see Large bedroom door, Small bedroom door and Medium bedroom door here.

>enter stairs
Hall
You see a dark room at north, stairs for the second floor and hear sounds like a radio from the Lavabo at east.

You can see Main door and Lavabo door here.

>n
Living Room
The room is lit only by the muted TV light.

You can see Dining Room door, Home office door, Living room door, Couch and TV here.

>unlock homme office door with spare key
You can't see any such thing.

>unlock home office door with spare key
You unlock Home office door.

>e
(first opening Home office door)

Home Office
A Home office like any other .

You can see Home office door, Big table and Colonel here.

>untie Colonel
You hahe untied Coronel
Let's get the fuck out of here!

>examine
What do you want to examine?

>examine big table
That`s a solid table. I bet I can try to climb it to reach the Elevated Window.

>climb on table
Now I can reach and unlock the elevated window from the inside!

>n
You can't go that way.

>s
You can't go that way.

>e
(first opening Elevated Window)

Garden
You go through a narrow path until reach an elevated window at west. It`s so hidden that almost feels like you found a secret path. You can hear voices inside, one of wich is Colonel's voice.

>sw
Porch
It's dark now, you can't be seen out here. You can see an armed guard sleeping in the chair.

You can see Main door, Garage door, a Wooden chair and bucket (in which are candle and string) here.

>inventory
You are carrying:
  Spare key
  Main key

>look
Porch
It's dark now, you can't be seen out here. You can see an armed guard sleeping in the chair.

You can see Colonel, Main door, Garage door, a Wooden chair and bucket (in which are candle and string) here.

* * *

>s
Living Room
The room is lit only by the muted TV light.

You can see Dining Room door, Home office door, Living room door, Couch and TV here.

You can hear voices at east, one of wich is Colonel's voice.

>examine tv
It's on mute and is showing the local news about a big armed conflict at Amestris.

You can hear voices at east, one of wich is Colonel's voice.

>examine couch
A small and damaged couch.

You can hear voices at east, one of wich is Colonel's voice.

>sit couch
I didn't understand that sentence.

>s
Hall
You see a dark room at north, stairs for the second floor and hear sounds like a radio from the Lavabo at east.

You can see Main door and Lavabo door here.

* * *

>enter stairs
Upper Hall
You can see Small bedroom door, Medium bedroom door and Large bedroom door here.

>s
Outter Bathroom

>n
Upper Hall
You can see Small bedroom door, Medium bedroom door and Large bedroom door here.

>e
(first opening Medium bedroom door)
It seems to be locked.

>w
(first opening Small bedroom door)
It seems to be locked.

>n
Large Bedroom
You can see Large bedroom door, Inner bathroom door and Bed (on which are Spare key and Liutenant's Cap) here.

>w
(first opening Inner bathroom door)

    *** Fuck! There's someone using the bathroom! You got shot and die. GAME OVER ***

Would you like to RESTART, RESTORE a saved game, QUIT or UNDO the last command?

>undo
Large Bedroom
[Previous turn undone.]

>get spare key
You hear a huge noise of someone slamming a door and shouting:

``I coudn't get any info from him yet Liutenant, he passed out! You try next! I'm gonna eat something and finish the report!``

And then someone shout back from the room right beside you:

``I'll finish here and I'll be there already. Just a sec!``

You freeze by the proximity of the voice and the only thing  you can think about is ``I need to move right now!``

Nelson I'm comming buddy!

* * *

>enter stairs
Hall
You see a dark room at north, stairs for the second floor and hear sounds like a radio from the Lavabo at east.

You can see Main door and Lavabo door here.

>e
(first opening Lavabo door)

Lavabo
A stinky used bathroom.

You can see Lavabo door here.

>w
Hall
You see a dark room at north, stairs for the second floor and hear sounds like a radio from the Lavabo at east.

You can see Lavabo door and Main door here.

>n
Living Room
The room is lit only by the muted TV light.

You can see Dining Room door, Home office door, Living room door, Couch and TV here.

>n
Dining Room
The dimly lit room highlights the bright screen of something on the table.

You can see Dining Room door, Private2, Sargeant, Private1, Kitchen portal and Messy table (on which is Laptop) here.

>e
You can't go that way.

>w
(first opening Kitchen portal)

    *** Fuck! The corporal noticed you! Before you try to run he pulls the gun out of the holster and BANG! You are dead.  GAME OVER ***

Would you like to RESTART, RESTORE a saved game, QUIT or UNDO the last command?

>undo
Dining Room
[Previous turn undone.]

>s
Living Room
The room is lit only by the muted TV light.

You can see Dining Room door, Home office door, Living room door, Couch and TV here.

>e
(first opening Home office door)
It seems to be locked.

>unlock home office door with spare key
You unlock Home office door.

* * *

>e
(first opening Home office door)

Home Office
A Home office like any other .

You can see Home office door, Big table and Colonel here.

>examine big table
That`s a solid table. I bet I can try to climb it to reach the Elevated Window.

* * *

>e
(first opening Elevated Window)
It seems to be locked.

>examine Colonel
You see nothing special about Colonel.

>untie colonel
You hahe untied Coronel
Let's get the fuck out of here!

>w
Living Room
The room is lit only by the muted TV light.

You can see Home office door, Dining Room door, Living room door, Couch and TV here.

>look
Living Room
The room is lit only by the muted TV light.

You can see Colonel, Home office door, Dining Room door, Living room door, Couch and TV here.

>e
Home Office
A Home office like any other .

You can see Home office door and Big table here.

>climb on big table
Now I can reach and unlock the elevated window from the inside!

>e
(first opening Elevated Window)

Garden
You go through a narrow path until reach an elevated window at west. It`s so hidden that almost feels like you found a secret path. You can hear voices inside, one of wich is Colonel's voice.

>look
Garden
You go through a narrow path until reach an elevated window at west. It`s so hidden that almost feels like you found a secret path. You can hear voices inside, one of wich is Colonel's voice.

You can see Colonel here.

>sw
Porch
It's dark now, you can't be seen out here. You can see an armed guard sleeping in the chair.

You can see Main door, Garage door, a Wooden chair and bucket (in which are candle and string) here.

>look
Porch
It's dark now, you can't be seen out here. You can see an armed guard sleeping in the chair.

You can see Colonel, Main door, Garage door, a Wooden chair and bucket (in which are candle and string) here.

* * *

>n
Living Room
The room is lit only by the muted TV light.

You can see Home office door, Living room door, Dining Room door, Couch and TV here.

You can hear voices at east, one of wich is Colonel's voice.

>examine Couch
A small and damaged couch.

You can hear voices at east, one of wich is Colonel's voice.

>examine TV
It's on mute and is showing the local news about a big armed conflict at Amestris.

You can hear voices at east, one of wich is Colonel's voice.

>n
(first opening Dining Room door)

Dining Room
The dimly lit room highlights the bright screen of something on the table.

You can see Dining Room door, Kitchen portal and Messy table (on which is Laptop) here.

* * *

>s
Hall
You see a dark room at north, stairs for the second floor and hear sounds like a radio from the Lavabo at east.

You can see Main door and Lavabo door here.

>climb stairs
I didn't understand that sentence.

>w
You can't go that way.

>e
(first opening Lavabo door)

    *** Fuck! There's someone using the bathroom! You got shot and die. GAME OVER ***

Would you like to RESTART, RESTORE a saved game, QUIT or UNDO the last command?

>s
Please give one of the answers above.

Would you like to RESTART, RESTORE a saved game, QUIT or UNDO the last command?

>n
Please give one of the answers above.

Would you like to RESTART, RESTORE a saved game, QUIT or UNDO the last command?

>n
Please give one of the answers above.

Would you like to RESTART, RESTORE a saved game, QUIT or UNDO the last command?

>w
Please give one of the answers above.

Would you like to RESTART, RESTORE a saved game, QUIT or UNDO the last command?

>undo
Hall
[Previous turn undone.]

>get Spare Key
You can't see any such thing.

>undo
Hall
[Previous turn undone.]

>s
Porch
It's dark now, you can't be seen out here. You can see an armed guard sleeping in the chair.

You can see Main door, Garage door, a Wooden chair (on which is Private1) and bucket (in which are candle and string) here.

>enter stairs
You can't see any such thing.

>n
Hall
You see a dark room at north, stairs for the second floor and hear sounds like a radio from the Lavabo at east.

You can see Main door and Lavabo door here.

>inventory
You are carrying:
  Main key

>s
Porch
It's dark now, you can't be seen out here. You can see an armed guard sleeping in the chair.

You can see Main door, Garage door, a Wooden chair (on which is Private1) and bucket (in which are candle and string) here.

* * *

>n
Hall
You see a dark room at north, stairs for the second floor and hear sounds like a radio from the Lavabo at east.

You can see Main door and Lavabo door here.

>get spare key
You can't see any such thing.

>s
Porch
It's dark now, you can't be seen out here. You can see an armed guard sleeping in the chair.

You can see Main door, Garage door, a Wooden chair (on which is Private1) and bucket (in which are candle and string) here.

* * *

>inventory
You are carrying:
  Main key

>e
(first opening Lavabo door)

    *** Fuck! There's someone using the bathroom! You got shot and die. GAME OVER ***

Would you like to RESTART, RESTORE a saved game, QUIT or UNDO the last command?

>unlock Home Office door
Please give one of the answers above.

Would you like to RESTART, RESTORE a saved game, QUIT or UNDO the last command?

>unlock Home Office door with spare key
Please give one of the answers above.

Would you like to RESTART, RESTORE a saved game, QUIT or UNDO the last command?

>e
Please give one of the answers above.

Would you like to RESTART, RESTORE a saved game, QUIT or UNDO the last command?

>close home office door
Please give one of the answers above.

Would you like to RESTART, RESTORE a saved game, QUIT or UNDO the last command?

>untie Colonel
Please give one of the answers above.

Would you like to RESTART, RESTORE a saved game, QUIT or UNDO the last command?

>undo
Hall
[Previous turn undone.]

>examine Colonel
You can't see any such thing.

>examine big table
You can't see any such thing.

>climb big table
I didn't understand that sentence.

>climb on big table
You can't see any such thing.

>look
Hall
You see a dark room at north, stairs for the second floor and hear sounds like a radio from the Lavabo at east.

You can see Main door and Lavabo door here.

* * *

>n
(first opening Main door)

Hall
You see a dark room at north, stairs for the second floor and hear sounds like a radio from the Lavabo at east.

You can see Main door and Lavabo door here.

Ok, I'm in. Now, where's Nelson...

>climb stairs
I didn't understand that sentence.

>enter stairs
Upper Hall
You can see Small bedroom door, Medium bedroom door and Large bedroom door here.

* * *

>enter stairs
Hall
You see a dark room at north, stairs for the second floor and hear sounds like a radio from the Lavabo at east.

You can see Main door and Lavabo door here.

>n
Living Room
The room is lit only by the muted TV light.

You can see Home office door, Living room door, Dining Room door, Couch and TV here.

>unlock home office door with spare key
You unlock Home office door.

* * *

>look
Home Office
A Home office like any other .

You can see Home office door, Big table and Colonel here.

>e
(first opening Elevated Window)
It seems to be locked.

>untie Colonel
You hahe untied Coronel
Let's get the fuck out of here!

>climb on big table
Now I can reach and unlock the elevated window from the inside!

* * *

>e
(first opening Elevated Window)

Garden
You go through a narrow path until reach an elevated window at west. It`s so hidden that almost feels like you found a secret path. You can hear voices inside, one of wich is Colonel's voice.

>undo
Home Office
[Previous turn undone.]

>undo
Home Office
[Previous turn undone.]

* * *

>n
(first opening Main door)

Hall
You see a dark room at north, stairs for the second floor and hear sounds like a radio from the Lavabo at east.

You can see Main door and Lavabo door here.

Ok, I'm in. Now, where's Nelson...

>enter stairs
Upper Hall
You can see Small bedroom door, Medium bedroom door and Large bedroom door here.

* * *

>n
Living Room
The room is lit only by the muted TV light.

You can see Home office door, Living room door, Dining Room door, Couch and TV here.

>n
(first opening Dining Room door)

    *** Fuck! 3 armed guards were laughing, but that was not enough for them not to shoot you. You are dead. GAME OVER ***

Would you like to RESTART, RESTORE a saved game, QUIT or UNDO the last command?

>undo
Living Room
[Previous turn undone.]

>unlock home office door with spare key
You unlock Home office door.

* * *

>e
(first opening Home office door)

Home Office
A Home office like any other .

You can see Home office door, Big table and Colonel here.

>untie colonel
You hahe untied Coronel
Let's get the fuck out of here!

>w
Living Room
The room is lit only by the muted TV light.

You can see Home office door, Living room door, Dining Room door, Couch and TV here.

>n
(first opening Dining Room door)

    *** Fuck! 3 armed guards were laughing, but that was not enough for them not to shoot you and the coronel. You are dead. GAME OVER ***

Would you like to RESTART, RESTORE a saved game, QUIT or UNDO the last command?

* * *

>unlock home office door with spare key
You unlock Home office door.

>w
(first opening Living room door)

Garage
The garage door is wide open. It's too dark in here and I don't want to make any noise. Better not touch anything. You can hear Kitchen sounds at north.

You can see Living room door, Garage door and Kitchen door here.

>e
Living Room
The room is lit only by the muted TV light.

You can see Living room door, Home office door, Dining Room door, Couch and TV here.

>e
(first opening Home office door)

Home Office
A Home office like any other .

You can see Home office door, Big table and Colonel here.

* * *

>n
(first opening Dining Room door)

    *** Fuck! 3 armed guards were laughing, but that was not enough for them not to shoot you and the coronel. You are dead. GAME OVER ***

Would you like to RESTART, RESTORE a saved game, QUIT or UNDO the last command?

>undo
Living Room
[Previous turn undone.]

>look
Living Room
The room is lit only by the muted TV light.

You can see Colonel, Home office door, Living room door, Dining Room door, Couch and TV here.

>s
Hall
You see a dark room at north, stairs for the second floor and hear sounds like a radio from the Lavabo at east.

You can see Main door and Lavabo door here.

>s
Porch
It's dark now, you can't be seen out here. You can see an armed guard sleeping in the chair.

You can see Garage door, Main door, a Wooden chair and bucket (in which are candle and string) here.

>look
Porch
It's dark now, you can't be seen out here. You can see an armed guard sleeping in the chair.

You can see Colonel, Garage door, Main door, a Wooden chair and bucket (in which are candle and string) here.

* * *

>w
Living Room
The room is lit only by the muted TV light.

You can see Home office door, Living room door, Dining Room door, Couch and TV here.

>s
Hall
You see a dark room at north, stairs for the second floor and hear sounds like a radio from the Lavabo at east.

You can see Main door and Lavabo door here.

>s
Porch
It's dark now, you can't be seen out here. You can see an armed guard sleeping in the chair.

You can see Main door, Garden arc, Garage door, a Wooden chair and bucket (in which are candle and string) here.

>undo
Hall
[Previous turn undone.]

>undo
Living Room
[Previous turn undone.]

>examine colonel
That's Nelson.

He's tired and hurt, but he's following me. Let's get out of this place.

>undo
Living Room
[Previous turn undone.]

>undo
Home Office
[Previous turn undone.]

>undo
Living Room
[Previous turn undone.]

>e
(first opening Home office door)

Home Office
A Home office like any other .

You can see Home office door, Big table and Colonel here.

>Examine colonel
That's Nelson.

He's tied up. Better help him.

>look
Home Office
A Home office like any other .

You can see Home office door, Big table and Colonel here.

>climb on big table
You're on the table.

>e
(first opening Elevated Window)
It seems to be locked.

* * *

>untie Colonel
You hahe untied Coronel
Let's get the fuck out of here!

>climb on big table
Now I can reach and unlock the elevated window from the inside!

You're on the table.

>e
(first opening Elevated Window)

Garden
You see an elevated window at west. It`s so hidden that almost feels like you found a secret path. 

You can see Garden arc here.

>look
Garden
A silent Garden.

You can see Colonel and Garden arc here.

>undo
Garden
[Previous turn undone.]

>undo
Home Office
[Previous turn undone.]

>e
(first opening Elevated Window)

Garden
You see an elevated window at west. It`s so hidden that almost feels like you found a secret path. 

You can see Garden arc here.

* * *

>unlock home office door with spare key
You unlock Home office door.

>untie colonel
You can't see any such thing.

>climb on big table
You can't see any such thing.

>e
(first opening Home office door)

Home Office
A Home office like any other .

You can see Home office door, Big table and Colonel here.

* * *

>untie colonel
You hahe untied Coronel
Let's get the fuck out of here!

>climb on big table
Now I can reach and unlock the elevated window from the inside!

You're on the table.

>open elevated window
You open Elevated Window.

>e
Garden
You can see an elevated window.

You can see Garden arc here.

>look
Garden
A silent Garden.

You can see Colonel and Garden arc here.

>sw
Porch
It's dark now, you can't be seen out here. You can see an armed guard sleeping in the chair.

You can see Garden arc, Main door, Garage door, a Wooden chair and bucket (in which are candle and string) here.

    *** Congratulations! You saved Colonel Nelson! GAME OVER ***

Would you like to RESTART, RESTORE a saved game, QUIT or UNDO the last command?

* * *

>examine private1
Sleep's like a baby. At ease private, keep up the good work.

* * *

>ne
Garden
You can see an elevated window.

You can see Garden arc here.

>look
Garden
You see an elevated window at west. It`s so hidden that almost feels like you found a secret path. You can hear voices inside, one of wich is Colonel's.

You can see Garden arc here.