Coming Home
An Interactive Fiction by Geraldo
Release 1 / Serial number 210121 / Inform 7 build 6M62 (I6/v6.33 lib 6/12N) SD

Porch
It's dark, you can't be seen out here. You can see an armed guard sleeping in the chair.

You can see Garage door, Main door, a Wooden chair (on which is Private1) and bucket (in which are Main key, candle and string) here.

>n
(first opening Main door)
It seems to be locked.

>n
Living Room

>s
Hall

* * *

>n
(first opening Main door)
It seems to be locked.

>up
Upper Hall
You can see Stairs here.

* * *

>n
(first opening Main door)
It seems to be locked.

>unlock Main door
What do you want to unlock Main door with?

* * *

>n
(first opening Main door)
It seems to be locked.

I beg your pardon?

I beg your pardon?

* * *

Coming Home
An Interactive Fiction by Geraldo
Release 1 / Serial number 210121 / Inform 7 build 6M62 (I6/v6.33 lib 6/12N) SD

Porch
It's dark, you can't be seen out here. You can see an armed guard sleeping in the chair.

You can see Garage door, Main door, a Wooden chair (on which is Private1) and bucket (in which are Main key, candle and string) here.

>look
Porch
It's dark, you can't be seen out here. You can see an armed guard sleeping in the chair.

You can see Garage door, Main door, a Wooden chair (on which is Private1) and bucket (in which are Main key, candle and string) here.

>up
You can't go that way.

>n
Hall
You can see Stairs here.

>look
Hall
You can see Stairs here.

>n
Living Room

>s
Hall
You can see Stairs here.

>s
Porch
You can see You here.

>n
Hall
You can see Stairs here.

>e
Lavabo

>w
Hall
You can see Stairs here.

>up
Upper Hall
You can see Stairs here.

>down
Hall
You can see Stairs here.

>climb stairs
Upper Hall
You can see Stairs here.

>climb stairs
Hall
You can see Stairs here.

>stairs
That's not a verb I recognise.

>enter Living Room
You can't see any such thing.

>enter staris
You can't see any such thing.

>enter stairs
Upper Hall
You can see Stairs here.

* * *

>look
Porch
It's dark, you can't be seen out here. You can see an armed guard sleeping in the chair.

You can see Garage door, Main door, a Wooden chair (on which is Private1) and bucket (in which are Main key, candle and string) here.

>n
(first opening Main door)
It seems to be locked.

>n
(first opening Main door)
It seems to be locked.

>examine Private1
Sleep's like a baby. At ease private, keep up the good work.

>steal Private1
That's not a verb I recognise.

>ne
Garden
You go through a narrow path until reach an elevated window at west. It`s so hidden that almost feels like you found a secret path. You can hear voices inside, one of wich is Colonel's voice.

>look
Garden
You go through a narrow path until reach an elevated window at west. It`s so hidden that almost feels like you found a secret path. You can hear voices inside, one of wich is Colonel's voice.

>w
(first opening Elevated Window)
It seems to be locked.

>s
You can't go that way.

>sw
Porch
It's dark, you can't be seen out here. You can see an armed guard sleeping in the chair.

You can see Garage door, Main door, a Wooden chair (on which is Private1) and bucket (in which are Main key, candle and string) here.

>nw
Garage
The garage door is wide open. It's too dark in here and I don't want to make any noise. Better not touch anything. You can hear Kitchen sounds at north.

You can see Garage door, Kitchen door and Living room door here.

>n
(first opening Kitchen door)

Kitchen
The corporal noticed you! Before you try to run he pulls the gun out of the holster and shoot you.  GAME OVER

You can see Kitchen door and Corporal here.

>s
Garage
The garage door is wide open. It's too dark in here and I don't want to make any noise. Better not touch anything. You can hear Kitchen sounds at north.

You can see Kitchen door, Garage door and Living room door here.

>e
(first opening Living room door)

Living Room
The room is lit only by the muted TV light. You can hear voices at east, one of wich is Colonel's voice.

You can see Home office door and Living room door here.

>s
Hall
You see a dark room at north and hear sounds like a radio from the Lavabo at east.

You can see Main door and Lavabo door here.

>up
Upper Hall
You can see Small bedroom door, Medium bedroom door and Large bedroom door here.

>n
Large Bedroom
You can see Large bedroom door, Inner bathroom door, Spare key and Bed table (on which is Clock) here.

>look
Large Bedroom
You can see Large bedroom door, Inner bathroom door, Spare key and Bed table (on which is Clock) here.

>get Spare key
Taken.

>s
Upper Hall
You can see Large bedroom door, Small bedroom door and Medium bedroom door here.

>e
(first opening Medium bedroom door)
It seems to be locked.

>w
(first opening Small bedroom door)
It seems to be locked.

>s
Outter Bathroom

>look
Outter Bathroom

>n
Upper Hall
You can see Large bedroom door, Small bedroom door and Medium bedroom door here.

>down
Hall
You see a dark room at north and hear sounds like a radio from the Lavabo at east.

You can see Main door and Lavabo door here.

>n
Living Room
The room is lit only by the muted TV light. You can hear voices at east, one of wich is Colonel's voice.

You can see Home office door and Living room door here.

>e
(first opening Home office door)
It seems to be locked.

>i
You are carrying:
  Spare key

>Open Home office door with Spare key
You unlock Home office door.

>e
(first opening Home office door)

Home Office
Finally found you Colonel. He looks beaten up and is unawake.

You can see Home office door, Sargeant and Colonel here.

>say hey! to sargeant
There is no reply.

>take colonel
Taken.

>i
You are carrying:
  Colonel
  Spare key

>look
Home Office
Finally found you Colonel. He looks beaten up and is unawake.

You can see Home office door and Sargeant here.

>e
(first opening Elevated Window)
It seems to be locked.

>w
Living Room
The room is lit only by the muted TV light. You can hear voices at east, one of wich is Colonel's voice.

You can see Home office door and Living room door here.

>s
Hall
You see a dark room at north and hear sounds like a radio from the Lavabo at east.

You can see Main door and Lavabo door here.

>up
Upper Hall
You can see Large bedroom door, Small bedroom door and Medium bedroom door here.

>n
Large Bedroom
You can see Large bedroom door, Inner bathroom door and Bed table (on which is Clock) here.

>look
Large Bedroom
You can see Large bedroom door, Inner bathroom door and Bed table (on which is Clock) here.

>set
What do you want to set?

>set clock
I didn't understand that sentence.

>set Clock
I didn't understand that sentence.

>set okk
You can't see any such thing.

>set o
You can't see any such thing.

>set ok
You can't see any such thing.

>sit on clock
You can't sit on Clock

* * *

Coming Home
An Interactive Fiction by Geraldo
Release 1 / Serial number 210121 / Inform 7 build 6M62 (I6/v6.33 lib 6/12N) SD

Porch
It's dark, you can't be seen out here. You can see an armed guard sleeping in the chair.

You can see Garage door, Main door, a Wooden chair (on which is Private1) and bucket (in which are Main key, candle and string) here.

>get key
A chill runs up your spine
Taken.

>unlock door
(with Main key)
You unlock Main door.

>n
(first opening Main door)

Hall
You can see Main door here.

>up
Upper Hall

>down
Hall
You can see Main door here.

* * *

>get key
A chill runs up your spine
Taken.

>unlock door with key
You unlock Main door.

>enter
You get onto Wooden chair.

>out
You get off Wooden chair.

Porch
You can see Main door, Wooden chair, Old box (in which are candle and string) and bucket (empty) here.

>n
(first opening Main door)

Hall
You can see Main door here.

>close door
You close Main door.

>scenes
Scene 'Entire Game' playing (for 6 mins now)
Scene 'Being Outside the House' ended
(Scene monitoring now switched on. Type "scenes off" to switch it off again.)

* * *

Coming Home
An Interactive Fiction by Geraldo
Release 1 / Serial number 210121 / Inform 7 build 6M62 (I6/v6.33 lib 6/12N) SD

Porch
It's dark, you can't be seen out here. You can see an armed guard sleeping in the chair.

You can see Garage door, Main door, a Wooden chair (on which is Private1) and bucket (in which are Main key, candle and string) here.

>sit
What do you want to sit on?

>sit on wooden chair
You cant sit in it

* * *

Coming Home
An Interactive Fiction by Geraldo
Release 1 / Serial number 210121 / Inform 7 build 6M62 (I6/v6.33 lib 6/12N) SD

Porch
It's dark, you can't be seen out here. You can see an armed guard sleeping in the chair.

You can see Garage door, Main door, a Wooden chair (on which is Private1) and bucket (in which are Main key, candle and string) here.

>sit on chair
You feel confortable

>look chair
You see nothing special about Wooden chair.

>get wooden chair
That's fixed in place.

>enter chair
That's not something you can enter.

* * *

>sit on chair
You feel confortable

>look
Porch (on Wooden chair)
You can see Main door, Main key and You here.

* * *

>sit on chair
You feel confortable

>up
(first getting off Wooden chair)
You can't go that way.

* * *

>sit on chair
You feel confortable

>out
You get off Wooden chair.

Porch
You can see Main door, Main key, You, Wooden chair, Old box (empty), thing1, thing2 and thing3 here.

>get thing1
Taken.

>put thing1 on chair
You put thing1 on Wooden chair.

>sit on chair
You can't sit in the Wooden chair, it is occupied

* * *

>look
Porch
You can see Main door, Main key, You, Wooden chair (on which is thing1), Old box (empty), thing2 and thing3 here.

I beg your pardon?

>out
But you aren't in anything at the moment.

>look
Porch
You can see Main door, Main key, You, Wooden chair (on which is thing1), Old box (empty), thing2 and thing3 here.

* * *

Coming Home
An Interactive Fiction by Geraldo
Release 1 / Serial number 210121 / Inform 7 build 6M62 (I6/v6.33 lib 6/12N) SD

Porch
It's dark, you can't be seen out here. You can see an armed guard sleeping in the chair.

You can see Garage door, Main door, a Wooden chair (on which is Private1) and bucket (in which are Main key, candle and string) here.

>enter chair
You get onto Wooden chair.

>out
You get off Wooden chair.

Porch
You can see Main door, Main key, You and Wooden chair here.

>sit on chair
You cant sit in it

>is chair seatable?
That's not a verb I recognise.

>help
That's not a verb I recognise.

* * *

Coming Home
An Interactive Fiction by Geraldo
Release 1 / Serial number 210121 / Inform 7 build 6M62 (I6/v6.33 lib 6/12N) SD

Porch
It's dark, you can't be seen out here. You can see an armed guard sleeping in the chair.

You can see Garage door, Main door, a Wooden chair (on which is Private1) and bucket (in which are Main key, candle and string) here.

>test me
>--> No test scripts exist for this game.

* * *

Coming Home
An Interactive Fiction by Geraldo
Release 1 / Serial number 210121 / Inform 7 build 6M62 (I6/v6.33 lib 6/12N) SD

Porch
It's dark, you can't be seen out here. You can see an armed guard sleeping in the chair.

You can see Garage door, Main door, a Wooden chair (on which is Private1) and bucket (in which are Main key, candle and string) here.

>sit on box
You can't sit on Old box

>look
Porch
You can see Main door, Main key, You, Wooden chair and Old box (empty) here.

>enter bpx
You can't see any such thing.

>enter box
That's not something you can enter.

* * *

>sit on box
You can't sit on Old box

>sit on chair
You can't sit on Wooden chair
You feel confortable

* * *

>sit on box
You can't sit on Old box

>get box
Taken.

>put box on chair
You put Old box on Wooden chair.

>sit chair
I didn't understand that sentence.

>sit on chair
You can't sit in a occupied chair

>get box
Taken.

>sit on chair
You feel confortable

* * *

>look
Porch (on Wooden chair)
You can see Main door, Main key and You here.

>get key
A chill runs up your spine
Taken.

* * *

>sit on box
You can't sit on Old box

>enter box
That's not something you can enter.

>enter chair
You get onto Wooden chair.

>look
Porch (on Wooden chair)
You can see Main door, Main key, You, Old box (empty), thing1, thing2 and thing3 here.

>get all
Main key: A chill runs up your spine
Taken.
You: Taken.
Old box: Taken.
thing1: Taken.
thing2: Taken.
thing3: Taken.

>i
You are carrying:
  thing3
  thing2
  thing1
  Old box
  You
  Main key

>drop me
You lack the dexterity.

>drop all
thing3: There is no more room on Wooden chair.
thing2: There is no more room on Wooden chair.
thing1: There is no more room on Wooden chair.
Old box: There is no more room on Wooden chair.
You: There is no more room on Wooden chair.
Main key: There is no more room on Wooden chair.

>exit
You get off Wooden chair.

Porch
You can see Main door and Wooden chair here.

>drop all
thing3: Dropped.
thing2: Dropped.
thing1: Dropped.
Old box: Dropped.
You: Dropped.
Main key: Dropped.

>get me
You are always self-possessed.

>i
You are carrying nothing.

>get all
Main key: A chill runs up your spine
Taken.
You: Taken.
Old box: Taken.
thing1: Taken.
thing2: Taken.
thing3: Taken.

* * *

>i
You are carrying:
  thing3
  thing2
  thing1
  Old box
  You
  Main key

>actions
Actions listing on.

>rules
Rules tracing now switched on. Type "rules off" to switch it off again, or "rules all" to include even rules which do not apply.

>actions off
Actions listing off.

>rules off
Rules tracing now switched off. Type "rules" to switch it on again.

>drop all
thing3: Dropped.
thing2: Dropped.
thing1: Dropped.
Old box: Dropped.
You: Dropped.
Main key: Dropped.

>get all
Main key: A chill runs up your spine
Taken.
You: Taken.
Old box: Taken.
thing1: Taken.
thing2: Taken.
thing3: Taken.

* * *

Coming Home
An Interactive Fiction by Geraldo
Release 1 / Serial number 210121 / Inform 7 build 6M62 (I6/v6.33 lib 6/12N) SD

Porch
It's dark, you can't be seen out here. You can see an armed guard sleeping in the chair.

You can see Garage door, Main door, a Wooden chair (on which is Private1) and bucket (in which are Main key, candle and string) here.

>get box
Taken.

* * *

>sit chair
I didn't understand that sentence.

>sit on chair
You cant sit in a occupied chair

* * *

Coming Home
An Interactive Fiction by Geraldo
Release 1 / Serial number 210121 / Inform 7 build 6M62 (I6/v6.33 lib 6/12N) SD

Porch
It's dark, you can't be seen out here. You can see an armed guard sleeping in the chair.

You can see Garage door, Main door, a Wooden chair (on which is Private1) and bucket (in which are Main key, candle and string) here.

>get Main key
A chill runs up your spine. You look at the private when he turns to you but he's still sleeping. Lucky me.

Taken.

>n
(first opening Main door)
It seems to be locked.

>open Main door
It seems to be locked.

>unlock Main door with Main key
You unlock Main door.

>n
(first opening Main door)

Hall
You can see Main door here.

>n
Living Room

* * *

>n
(first opening Main door)
It seems to be locked.

>unlock Main door
(with Main key)
You unlock Main door.

>n
(first opening Main door)

Hall
You can hear sounds like a radio from the Lavabo at east.

You can see Main door and Lavabo door here.

>close Main door
You close Main door.

* * *

>get Main key
A chill runs up your spine. You look at the private when he turns to you but he's still sleeping. Lucky me.

Taken.

>unlock Main door
(with Main key)
You unlock Main door.

>open Main door
You open Main door.

>n
Hall
You can hear sounds like a radio from the Lavabo at east.

You can see Main door and Lavabo door here.

>close Main door
You close Main door.

>look
Hall
You can hear sounds like a radio from the Lavabo at east.

You can see Main door and Lavabo door here.

* * *

Coming Home
An Interactive Fiction by Geraldo
Release 1 / Serial number 210121 / Inform 7 build 6M62 (I6/v6.33 lib 6/12N) SD

Porch
It's dark, you can't be seen out here. You can see an armed guard sleeping in the chair.

You can see Garage door, Main door, a Wooden chair (on which is Private1) and bucket (in which are Main key, candle and string) here.

>northeast
Garden
You go through a narrow path until reach an elevated window at west. It`s so hidden that almost feels like you found a secret path. You can hear Colonel's voice at the inside.

>look
Garden
You go through a narrow path until reach an elevated window. It`s so hidden that almost feels like you found a secret path. You can hear a familiar voice from inside.

>s
You can't go that way.

>southwest
Porch
It's dark, you can't be seen out here. You can see an armed guard sleeping in the chair.

You can see Main door, a Wooden chair (on which is Private1) and bucket (in which are Main key, candle and string) here.

* * *

>northeast
Garden
You go through a narrow path until reach an elevated window at west. It`s so hidden that almost feels like you found a secret path. You can hear Colonel's voice at the inside.

>southeast
You can't go that way.

>southwest
Porch
It's dark, you can't be seen out here. You can see an armed guard sleeping in the chair.

You can see Main door, a Wooden chair (on which is Private1) and bucket (in which are Main key, candle and string) here.

>Wodden chair
That's not a verb I recognise.

>examine Wodden chair
You can't see any such thing.

>examine Wooden chair
On the Wooden chair is Private1.

>examine
What do you want to examine?

>Private1
You see nothing special about Private1.

* * *

>northeast
Garden
You go through a narrow path until reach an elevated window at west. It`s so hidden that almost feels like you found a secret path. You can hear Colonel's voice at the inside.

>west
(first opening Elevated Window)
It seems to be locked.

* * *

Coming Home
An Interactive Fiction by Geraldo
Release 1 / Serial number 210121 / Inform 7 build 6M62 (I6/v6.33 lib 6/12N) SD

Porch
It's dark, you can't be seen out here. You can see an armed guard sleeping in the chair.

You can see Garage door, Main door, a Wooden chair (on which is Private1) and bucket (in which are Main key, candle and string) here.

>examine Private1
You see nothing special about Private1.

>Private1
That's not a verb I recognise.

>look Private1
You see nothing special about Private1.

>hit Private1
Violence isn't the answer to this one.

>ask Private1
What do you want to ask Private1 for?

>ask Private1 who are you
I didn't understand that sentence.

>examine Wooden chair
On the Wooden chair is Private1.

* * *

Coming Home
An Interactive Fiction by Geraldo
Release 1 / Serial number 210121 / Inform 7 build 6M62 (I6/v6.33 lib 6/12N) SD

Porch
It's dark, you can't be seen out here. You can see an armed guard sleeping in the chair.

You can see Garage door, Main door, a Wooden chair (on which is Private1) and bucket (in which are Main key, candle and string) here.

>silently get Main key
That's not a verb I recognise.

>get Main key silently
I only understood you as far as wanting to get Main key.

>get Main key
A chill runs up your spine
Taken.

* * *

Coming Home
An Interactive Fiction by Geraldo
Release 1 / Serial number 210121 / Inform 7 build 6M62 (I6/v6.33 lib 6/12N) SD

Porch
It's dark, you can't be seen out here. You can see an armed guard sleeping in the chair.

You can see Garage door, Main door, a Wooden chair (on which is Private1) and bucket (in which are Main key, candle and string) here.

>Garage door
That's not a verb I recognise.

>look Garage door
You see nothing special about Garage door.

>n
(first opening Main door)
It seems to be locked.

>w
You can't go that way.

>s
You can't go that way.

>look
Porch
It's dark, you can't be seen out here. You can see an armed guard sleeping in the chair.

You can see Garage door, Main door, a Wooden chair (on which is Private1) and bucket (in which are Main key, candle and string) here.

>examine Private1
You see nothing special about Private1.

* * *

Coming Home
An Interactive Fiction by Geraldo
Release 1 / Serial number 210121 / Inform 7 build 6M62 (I6/v6.33 lib 6/12N) SD

Porch
It's dark, you can't be seen out here. You can see an armed guard sleeping in the chair.

You can see Garage door, Main door, a Wooden chair (on which is Private1) and bucket (in which are Main key, candle and string) here.

>set alar
That's not a verb I recognise.

>set alarm
That's not a verb I recognise.

>set
That's not a verb I recognise.

>remove Private1 from Wooden chair
I don't suppose Private1 would care for that.

>look
Porch
It's dark, you can't be seen out here. You can see an armed guard sleeping in the chair.

You can see Garage door, Main door, a Wooden chair (on which is Private1) and bucket (in which are Main key, candle and string) here.

* * *

Coming Home
An Interactive Fiction by Geraldo
Release 1 / Serial number 210121 / Inform 7 build 6M62 (I6/v6.33 lib 6/12N) SD

Porch
It's dark, you can't be seen out here. You can see an armed guard sleeping in the chair.

You can see Garage door, Main door, a Wooden chair (on which is Private1) and bucket (in which are Main key, candle and string) here.

>nw
Garage
The garage door is wide open. It's too dark in here and I don't want to make any noise. Better not touch anything. You can hear Kitchen sounds at north.

You can see Garage door, Kitchen door and Living room door here.

>e
(first opening Living room door)

Living Room
The room is lit only by the muted TV light. You can hear voices at east, one of wich is Colonel's voice.

You can see Home office door and Living room door here.

* * *

>up
Upper Hall
You can see Small bedroom door, Medium bedroom door and Large bedroom door here.

>n
Large Bedroom
You can see Large bedroom door, Inner bathroom door, Bed table (on which is Alarm clock) and Spare key here.

>set Alarm clock
it will be noisy, you better run

* * *

>n
Large Bedroom
You can see Large bedroom door, Inner bathroom door, Bed table (on which is Alarm clock) and Spare key here.

>set Alarm clock
it will be noisy, you better run
You'll have to say which compass direction to go in.
I didn't understand that instruction.
sargs moves!

>s
Upper Hall
You can see Large bedroom door, Small bedroom door and Medium bedroom door here.

You'll have to say which compass direction to go in.
I didn't understand that instruction.
sargs moves!

>n
Large Bedroom
You can see Large bedroom door, Inner bathroom door, Bed table (on which is Alarm clock) and Spare key here.

You'll have to say which compass direction to go in.
I didn't understand that instruction.
sargs moves!

>s
Upper Hall
You can see Large bedroom door, Small bedroom door and Medium bedroom door here.

You'll have to say which compass direction to go in.
I didn't understand that instruction.
sargs moves!

>down
Hall
You see a dark room at north and hear sounds like a radio from the Lavabo at east.

You can see Main door and Lavabo door here.

You'll have to say which compass direction to go in.
I didn't understand that instruction.
sargs moves!

>n
Living Room
The room is lit only by the muted TV light. You can hear voices at east, one of wich is Colonel's voice.

You can see Home office door and Living room door here.

You'll have to say which compass direction to go in.
I didn't understand that instruction.
sargs moves!

>s
Hall
You see a dark room at north and hear sounds like a radio from the Lavabo at east.

You can see Main door and Lavabo door here.

You'll have to say which compass direction to go in.
I didn't understand that instruction.
sargs moves!

>up
Upper Hall
You can see Large bedroom door, Small bedroom door and Medium bedroom door here.

You'll have to say which compass direction to go in.
I didn't understand that instruction.
sargs moves!

>n
Large Bedroom
You can see Large bedroom door, Inner bathroom door, Bed table (on which is Alarm clock) and Spare key here.

You'll have to say which compass direction to go in.
I didn't understand that instruction.
sargs moves!

>take key
Taken.

You'll have to say which compass direction to go in.
I didn't understand that instruction.
sargs moves!

>s
Upper Hall
You can see Large bedroom door, Small bedroom door and Medium bedroom door here.

You'll have to say which compass direction to go in.
I didn't understand that instruction.
sargs moves!

* * *

>down
Hall
You see a dark room at north and hear sounds like a radio from the Lavabo at east.

You can see Main door and Lavabo door here.

You'll have to say which compass direction to go in.
I didn't understand that instruction.
sargs moves!

>up
Upper Hall
You can see Large bedroom door, Small bedroom door and Medium bedroom door here.

You'll have to say which compass direction to go in.
I didn't understand that instruction.
sargs moves!

>down
Hall
You see a dark room at north and hear sounds like a radio from the Lavabo at east.

You can see Main door and Lavabo door here.

You'll have to say which compass direction to go in.
I didn't understand that instruction.
sargs moves!

* * *

>n
Living Room
The room is lit only by the muted TV light. You can hear voices at east, one of wich is Colonel's voice.

You can see Home office door and Living room door here.

You'll have to say which compass direction to go in.
I didn't understand that instruction.
sargs moves!

>open door with key
Which do you mean, Home office door or Living room door?

>open Home Office door with key
You unlock Home office door.

You'll have to say which compass direction to go in.
I didn't understand that instruction.
sargs moves!

>e
(first opening Home office door)

Home Office
Finally found you Colonel. He looks beaten up and is unawake.

You can see Home office door, Sargeant and Colonel here.

You'll have to say which compass direction to go in.
I didn't understand that instruction.
sargs moves!
Sargeant finds you, now you're dead

* * *

>n
Large Bedroom
You can see Large bedroom door, Inner bathroom door, Bed table (on which is Alarm clock) and Spare key here.

>get key
Taken.

>set clock
it will be noisy, you better run
You'll have to say which compass direction to go in.
I didn't understand that instruction.
sargs moves!

>best route from kitchen to Large bedroom
That's not a verb I recognise.

>Sargeant, go to kitchen
You seem to want to talk to someone, but I can't see whom.

>take key
You already have that.

You'll have to say which compass direction to go in.
I didn't understand that instruction.
sargs moves!

>s
Upper Hall
You can see Large bedroom door, Small bedroom door and Medium bedroom door here.

You'll have to say which compass direction to go in.
I didn't understand that instruction.
sargs moves!

>d
Hall
You see a dark room at north and hear sounds like a radio from the Lavabo at east.

You can see Main door and Lavabo door here.

You'll have to say which compass direction to go in.
I didn't understand that instruction.
sargs moves!

>u
Upper Hall
You can see Large bedroom door, Small bedroom door and Medium bedroom door here.

You'll have to say which compass direction to go in.
I didn't understand that instruction.
sargs moves!

>d
Hall
You see a dark room at north and hear sounds like a radio from the Lavabo at east.

You can see Main door and Lavabo door here.

You'll have to say which compass direction to go in.
I didn't understand that instruction.
sargs moves!

>n
Living Room
The room is lit only by the muted TV light. You can hear voices at east, one of wich is Colonel's voice.

You can see Home office door and Living room door here.

You'll have to say which compass direction to go in.
I didn't understand that instruction.
sargs moves!

>open HO door with key
You can't see any such thing.

>open Home Office door with key
You unlock Home office door.

You'll have to say which compass direction to go in.
I didn't understand that instruction.
sargs moves!

* * *

>e
(first opening Home office door)

Home Office
Finally found you Colonel. He looks beaten up and is unawake.

You can see Home office door, Sargeant and Colonel here.

You'll have to say which compass direction to go in.
I didn't understand that instruction.
sargs moves!
Sargeant finds you, now you're dead

>Sargeant, go to Kitchen
Sargeant looks amused, but accepts the commission to go to Kitchen.

You'll have to say which compass direction to go in.
I didn't understand that instruction.
sargs moves!
Sargeant finds you, now you're dead

>look
Home Office
Finally found you Colonel. He looks beaten up and is unawake.

You can see Home office door, Sargeant and Colonel here.

You'll have to say which compass direction to go in.
I didn't understand that instruction.
sargs moves!
Sargeant finds you, now you're dead

* * *

>s
Hall
You see a dark room at north and hear sounds like a radio from the Lavabo at east.

You can see Main door and Lavabo door here.

>u
Upper Hall
You can see Small bedroom door, Medium bedroom door and Large bedroom door here.

>n
Large Bedroom
You can see Large bedroom door, Inner bathroom door, Bed table (on which is Alarm clock) and Spare key here.

>take key
Taken.

>set clock
it will be noisy, you better run
HO door unlocked
sargs moves from Living Room in west direction to Large Bedroom!

>set clock
it's already setted
sargs moves from Hall in south direction to Large Bedroom!

>Sargeant, go to Living room
You seem to want to talk to someone, but I can't see whom.

>set clock
it's already setted
sargs moves from Upper Hall in up direction to Large Bedroom!

>look
Large Bedroom
You can see Large bedroom door, Inner bathroom door and Bed table (on which is Alarm clock) here.

Sargeant arrives from the south.

sargs moves from Large Bedroom in north direction to Large Bedroom!
Sargeant finds you, now you're dead

* * *

>set clock
it will be noisy, you better run
HO door unlocked
sargs moves from Living Room in west direction to Large Bedroom!

>s
Upper Hall
You can see Large bedroom door, Small bedroom door and Medium bedroom door here.

HO door locked
sargs moves from Hall in south direction to Large Bedroom!

>s
Outter Bathroom
sargs moves from Upper Hall in up direction to Large Bedroom!
You hear some steps from Upper Hall

>look
Outter Bathroom
sargs moves from Large Bedroom in north direction to Large Bedroom!

>n
Upper Hall
You can see Large bedroom door, Small bedroom door and Medium bedroom door here.

>d
Hall
You see a dark room at north and hear sounds like a radio from the Lavabo at east.

You can see Main door and Lavabo door here.

>n
Living Room
The room is lit only by the muted TV light. You can hear voices at east, one of wich is Colonel's voice.

You can see Home office door and Living room door here.

>open home office door with key
You unlock Home office door.

>lock home office door
(with Spare key)
First you would have to close Home office door.

I beg your pardon?

* * *

>n
Living Room
The room is lit only by the muted TV light. You can hear voices at east, one of wich is Colonel's voice.

You can see Home office door and Living room door here.

>e
Home Office
Finally found you Colonel. He looks beaten up and is unawake.

You can see Home office door and Colonel here.

* * *

>n
Large Bedroom
You can see Large bedroom door, Inner bathroom door, Bed table (on which is Alarm clock) and Spare key here.

>set clock
it will be noisy, you better run
HO door unlocked
sargs moves from Living Room in west direction to Large Bedroom!

* * *

>s
Upper Hall
You can see Large bedroom door, Small bedroom door and Medium bedroom door here.

HO door locked
sargs moves from Hall in south direction to Large Bedroom!

I beg your pardon?

>s
Outter Bathroom
sargs moves from Upper Hall in up direction to Large Bedroom!
You hear some steps from Upper Hall

* * *

>n
Living Room
The room is lit only by the muted TV light. You can hear voices at east, one of wich is Colonel's voice.

You can see Home office door and Living room door here.

>examine Home Office door
You see nothing special about Home office door.

>i
You are carrying nothing.

>open Home Office door
It seems to be locked.

>e
Home Office
Finally found you Colonel. He looks beaten up and is unawake.

You can see Home office door and Colonel here.

>w
Living Room
The room is lit only by the muted TV light. You can hear voices at east, one of wich is Colonel's voice.

You can see Home office door and Living room door here.

I beg your pardon?

>unlock Home office door
What do you want to unlock Home office door with?

>key
You can't see any such thing.

>unlock Home office door with key
You can't see any such thing.

>open Home office door
It seems to be locked.

>close Home office door
You close Home office door.

>open Home office door
It seems to be locked.

>e
(first opening Home office door)
It seems to be locked.

* * *

>u
Upper Hall
You can see Small bedroom door, Medium bedroom door and Large bedroom door here.

>up
You can't go that way.

>n
Large Bedroom
You can see Large bedroom door, Inner bathroom door, Bed table (on which is Alarm clock) and Spare key here.

>gek key
That's not a verb I recognise.